!-- 코드를 알파벳 순으로 기입함 -->
!-- 긴 문구부터 작성하여, 짧은 문구가 먼저 replace되는 경우가 발생하지 않도록 함 -->
!-- 메세지 -->

agree=예, 이용 약관에 동의합니다.
acceptPeakAlarm=피크 알람을 받습니다.
acceptEqmtAlarm=시설물 냉장비 알람을 받습니다.
alarmHistNotExist=알람 내역이 없습니다.
changeSuccess=변경 완료 했습니다.
changeFail=변경 할 수 없습니다.
checkInput=입력을 확인하세요.
commSuccess=통신에 성공하였습니다.
commFail=통신에 실패하였습니다.
deny=아니오, 이용 약관에 동의하지 않습니다.
gwCommFail=G/W와 통신연결에 실패
contElecMgntStr=계약전력 관리 점포 대상
dimHigh=디밍을 90이상으로 할 수 없습니다.
dimLow=디밍을 60이하로 할 수 없습니다.
eqmtNotExist=시설물이 없습니다.
errorHappens=에러가 발생하였습니다.
findIdpw=등록된 이메일 주소를 통해 ID/PW 정보를 찾을 수 있습니다.
loginInfoNotCorrect=로그인 정보가 올바르지 않습니다.
sessionInvalid=세션이 유효하지 않습니다.
sessionInfoNotCorrect=세션 정보가 올바르지 않습니다.
notSame=새로운 암호가 일치하지 않습니다.
rsltNotExist=조회 결과가 없습니다.
onlyForMobile=모바일에서만 가능합니다. * 모바일에서 열리지 않을 경우, 앱 종료 후 재시도 바랍니다.
pwChange=PW를 변경합니다.
regiDev=접속하신 ID에 현재 단말기를 등록합니다
saveSuccess=성공적으로 저장하였습니다.
saveSuccessRetFail=저장했으나 데이터 조회에 실패했습니다.
saveFail=저장에 실패하였습니다.
selectHomeDisp=홈으로 지정하고자 하는 화면을 선택하세요.
idStrNotExist=ID에 등록된 점포가 존재하지 않습니다.
typeCorrectly=정확히 입력해주세요.
typeId=ID를 입력하세요.
typePw=Password를 입력하세요.
tryAgain=다시 시도해주세요.

!-- 긴 문구(단어가 조합된 단어) -->

accmUsage=누적 사용량
alarmHist=알람 내역
alarmRaiseTime=알람 발생 시간
avgTempCtrlUsage=평균 냉난방 가동량
avgTempCtrlHour=평균 냉난방 가동 시간
avgDimmingLevel=평균 디밍 레벨
checkNewPw=새로운 암호 확인
commError=통신이상
coolingEqmtState=냉장비 상태 조회
dimmingSetting=디밍 설정
dimmingLevel=디밍 레벨
emailAddrRegi=이메일 주소 등록
enerUsage=에너지 사용량
enerUsageAnal=에너지 사용량 분석
enerUsagePerStr=점포별 에너지 사용량
eqmtAlarm=시설물 알람
eqtInfo=시설정보
hacUsage=냉난방 사용량
highTemp=상한온도
homeSelect=홈화면 지정
hqRecomm=본부 권고
lowTemp=하한온도
myStr=나의 점포
notFunc=기능 없음
orgCd=조직코드
orgNm=조직명
orgTree=조직도
prevPw=변경 전 암호
passwordMod=비밀번호 변경
peakAlarm=피크 알람
pwMod=PW 변경
pushRegi=푸시 등록
pushMsgReceiveRegi=푸시 메세지 수신 등록
remsLogin=REMS 로그인
recentMonthAlarmCnt=최근 한달 알람 횟수
retrieveTime=조회 시간
rememberMe=자동로그인
selectLocale=언어 선택
similarStrAvg=유사점포 평균
signSetting=간판 설정
strAlarmList=점포 알람 목록
strCompare=점포비교
strNm=점포명
strState=점포상태
strAvgIndoorTemp=점포 평균 실내 온도
strElecUsagePerSpace=점포 면적당 전력량
sunriseTime=일출시간
sunsetTime=일몰시간
tempCali=온도 보정
tempTrend=온도 추이
tempCtrlMode=냉난방 모드
tempCtrlOper=냉난방 가동
tempCtrlOperState=냉난방 가동 상태
tempCtrlOperTimeLine=냉난방 가동 시간대
tempCtrlOperTimeCheck=냉난방 가동 시간 확인
tempCtrlOperTimeSetting=냉난방 가동 시간 설정
tempCtrlPref=냉난방 선호도
thisMonthPredict=이번달 예측
totalUsage=전체 사용량
typeNewPw=새로운 암호 입력
useWattage=사용 전력량
userAgreement=사용자 약관
usagePerSpace=면적당 전력량
searchStr=점포조회
alarmList=알람리스트

!-- 짧은 문구 -->

apr=4월
alarm=알람
anal=분석
avg=평균
accm=누적
afternoon=오후
aug=8월
cali=보정
casher=계산대
change=변경
clos=닫 기
close=닫기
cloud=구름
cloudy=흐림
cnfm=확인
cnt=횟수
compare=비교
cooling=냉방
coolingEqt=냉장비
date=일자
dec=12월
delay=지연
device=장치
diff=증감
dim=디밍
ener=에너지
elecWatt=전력
eqmt=시설물
eqt=시설
feb=2월
fog=안개
friday=금요일
func=기능
good=정상
hac=냉난방
heating=난방
hist=내역
hq=본부
id=아이디
indoor=실내
info=정보
jan=1월
jun=6월
jul=7월
lastMonth=지난달
layout=레이아웃
less=조금
logout=로그아웃
lvl=레벨
mar=3월
may=5월
mod=변 경
mode=모드
monday=월요일
more=많음
morning=오전
msg=메세지
none=없음
nov=11월
office=사무실
oct=10월
oper=가동
open=열 기
password=비밀번호
perSpace=면적당
present=현재
prefer=선호도
push=푸시
recent=최근
receive=수신
recomm=권고
regi=등록
retireve=조회
saturday=토요일
save=저 장
sep=9월
similar=유사
sign=간판
setting=설정
snow=눈
shower=소나기
srch=찾기
state=상태
strNm=점포명
str=점포
sunday=일요일
sunny=맑음
sunrise=일출
sunset=일몰
temp=온도
timeLine=시간대
time=시간
thisMonth=이번달
thursday=목요일
tuesday=화요일
lightning=낙뢰
list=목록
outdoor=실외
oneMonth=한달
org=조직
peak=피크
predict=예측
pw=비밀번호
rise=발생
rslt=결과
thisMonth1=이번 달 1일
today=오늘
total=전체
trend=추이
use=사용
usage=가동
wednesday=수요일
yesterday=어제
yearMonthDay=년월일
warn=이상

!-- 한 음절 -->

amnt=량
day=일
month=월
hh=시
mm=분
per=별
rain=비
week=주
year=년